type octile
height 41
width 41
map
..TTTTTTTTTTTTTTTTTTTTTTTTTTTTTTTTTTTTTTT
........................................T
T.......................................T
T...................T...................T
T...................T...................T
T...................T...................T
T...................T...................T
TTTT.......TTTTTTTTTTTTTTTTTTTTT........T
T..........T............................T
T..........T............................T
T..........T............................T
T..........T............................T
T..........T............................T
T..........T............................T
T..........T.........TTTTTTTTTTT.....TTTT
T....................T..................T
T....................T..................T
T.......................................T
T.......................................T
T..........T............................T
T..........T.........T..................T
TTTTTTTTTTTT.........T..................T
T..........TTTTTTTTTTT..................T
T.......................................T
T............................TTTTTTTTTTTT
T.......................................T
T.......................................T
T..........TTTTTTTTTTT..................T
T..........T.........T..................T
T..........T.........T..................T
T..........T.........T..................T
T..........T.........T..................T
T..........T.........TTTTTTTT......TTTTTT
T..........T............................T
T..........T............................T
T..........T............................T
T..........T............................T
T..........................T............T
T..........................T............T
T..........................T.............
TTTTTTTTTTTTTTTTTTTTTTTTTTTTTTTTTTTTTTTT.