type octile
height 49
width 49
map
..TTTTTTTTTTTTTTTTTTTTTTTTTTTTTTTTTTTTTTTTTTTTTTTTTTTTTTTTTTTTTTTTTTTTTTTTTTTTTTTTTTTTTTTTTTTTTTTTT
..T.......T.......T.T.....T.....T.T.......T.....T.......T.......T.....T.....T.......T.T...T.....T.T
T.T.TTT.T.T.TTTTTTT.T.TTTTT.TTT.T.T.TTTTT.T.TTT.T.T.TTTTTTT.T.TTT.T.TTT.TTT.T.T.T.T.T.TTT.T.T.TTT.T
T.T.T...T.....T.....T...T.....T.T.......T...T...T.T.T.......T...T.T.T...T...T.T.T.T.......T.T.T.T.T
T.TTT.T.TTTTTTT.TTTTT.T.T.TTTTT.T.TTT.TTTTTTTTT.TTT.TTTTT.T.TTTTT.TTT.TTTTTTT.T.TTT.TTTTTTT.T.T.T.T
T.....T...T.........T.T.....T.T.....T.T...........T.T...T.T.T.......T...T.T.T.T...T.....T...T.....T
T.TTT.T.TTT.......TTT.TTTTTTT.T.TTTTTTTT........T.T.T.TTT.T.TTT....TTTT.T.T.TTT.TTT.T.TTT.T.T.T.T.T
T.T.T.T...T.....T.......T.T...T...T.T...........T...T.T...T.T.....T...T.........T...T...T.T.T.T.T.T
T.T.T.TTTTTTT.T.TTT.TTT.T.TTT.TTT.T.T.TTT.T.T.T.TTTTT.T.T.T.T.T.TTT.T.TTTTT.T.TTTTT.TTTTT.T.TTTTTTT
T.T.....T...T.T.T.T...T.T.............T...T.T.T.T...T.T.T.T...T...T.T...T.T.T...T.........T.T...T.T
T.TTT.TTT.TTTTT.T.T.T.TTTTT.TTTTTTT.TTTTTTTTTTT.TTT.T.TTT.T.TTT.TTT.TTT.T.T.T.T.TTTTTTT.T.T.T.T.T.T
T.T.......T.......T.T.T...........T...T.......T.....T...T.T...T...T.T.......T.T...T.T...T.T...T...T
T.TTTTT.TTT.......TTTTT.........TTTTT.TTTTTTT.T.TTTTT.TTT.TTTTTTT.TTTTT.....TTT.TTT.TTTTT.TTTTTTT.T
T...T.....T.......T...T.....T.......T.T.T...T...T.T.T...T.T.......T...T.....T...T.....T...T.T.T...T
TTT.TTTTT.TTT.T.TTT.T.T.TTT.TTT.TTTTTTT.TTT.T.TTT.T.TTT.TTT.TTTTTTT.TTTTTTTTTTT.T.TTTTT.TTT.T.T.TTT
T.T.T.........T.......................T.....T.T.......T.......T...T.......T...T.T...T.T.......T...T
T.TTTTT.TTT.T.TTT.T...........TTTTT.TTT.T...TTTTTTT.TTT.....T.T.T.T.TTT.T.TTT.T.T.TTT.TTTTTTTTTTT.T
T.....T.T...T.T.T.T.........T.....T.....T...T.........T...T.....T.T.T.T.T...T...T.T.T.......T...T.T
TTT.T.TTTTT.T.T.TTT.........T.TTT.TTTTTTT.T.T.TTTTTTTTT.TTTTT.T.T.T.T.TTTTT.T.TTT.T.T.TTTTT.TTT.TTT
T...T.....T.T.T.....T.T.T.....T.T...T.T.T.T.........T.....T...T.T.T...T.....T...T...T...T.T.T.....T
TTTTT.T.T.T.TTT.TTT.T.TTTTTTTTT.T.TTT.T.TTTTT.TTTTTTTTT.TTT.T.TTTTT.TTT.TTTTTTT.TTT.T.T.T.T.TTTTT.T
T.....T.T...T.T.T...T...........T.....T...T.......T...T...T.T...T...T.......T.........T.T.........T
T.TTT.TTT.T.T.T.T.T.TTTTTTT.TTTTTTTTTTTTT.T.TTT.TTT.TTTTT.TTTTT.T.TTT.T.TTTTTTTTTTTTT.TTT.T.T.TTTTT
T.T.....T.T.....T.T...T...T.T.T.T.....T.....T.T.....T.T.....T.....T...T.T...T.T.......T.T.T.T.....T
TTTTT.T.TTTTT.TTT.TTT.T.TTT.T.T.T.TTTTT.TTT.T.TTTTTTT.T.TTT.T.T.TTTTTTTTT.TTT.T.TTTTT.T.T.T.T.TTT.T
T.T...T.....T...T.T.......T.T.............T.T.T.T.T.T...T.....T...T.T.T...T...T.T.T.....T.T.T...T.T
T.T.TTTTTTTTT.TTTTTTT.T.TTTTTTTTTTT.T.T.TTTTT.T.T.T.T.TTTTTTT.TTT.T.T.T.TTTTT.T.T.TTT.T.TTTTT.TTTTT
T.T.T.......T.......T.T...T.....T...T.T.....T...........T.....T.T.T...T.......T...T...T...T.......T
T.T.T.T.TTT.TTT.TTT.T.T.TTT.T.TTT.TTTTTTTTTTT.TTTTTTT.T.T.TTTTT.T.TTT.T.T.TTTTT.TTTTTTT.TTTTT.TTT.T
T...T.T.T...T...T...T.T...T.T.......T.T...T.......T...T.T.....T...T.T...T.T.T.T.T.......T.T...T...T
TTT.T.TTT.T.T.TTTTT.TTTTTTTTTTTTT.TTT.TTT.TTT....TTTT.TTTTT.TTT.T.T.TTT.TTT.T.TTTTT.TTTTT.T.TTTTTTT
T.T...T...T.T.....T.....T.......T.....T.T.T.T...T.......T.....T.T.....T.T...T.T.......T...T.....T.T
T.T.T.TTTTTTT.T.TTTTTTT.TTTTT.TTTTTTT.T.T.T.T.TTTTTTT.TTTTT.TTTTTTT.T.T.T.TTT.TTT.TTT.TTT.T.TTTTT.T
T.T.T.T.......T.T...T...T.........T.T.....T.....T...T.T.T.....T.....T.........T.T...T.....T.......T
T.TTTTT.TTTTTTTTT.TTT.TTT.TTTTT.T.T.T.TTT.T.TTTTTTT.T.T.TTT.T.TTTTTTT.TTTTTTTTT.TTT.T.T.T.TTTTT.T.T
T.T...T...T...........T.....T...T.T...T...T.......T.....T...T.....T.T...........T...T.T.T.T.....T.T
T.T.TTT.TTTTT.T.T.TTT.T.TTTTT.T.T.T.TTTTTTTTT.T.TTT.T.TTTTT.TTTTTTT.T.TTT.T.T.TTT.T.T.TTTTTTTTT.TTT
T.T.........T.T.T...T.....T...T.T.....T.......T...T.T...T.........T.....T.T.T...T.T.T.T...T...T...T
T.T.TTT......TTTT.T.TTTTT.T.TTT.TTTTT.TTT.TTTTT.TTT.T.TTTTT.TTTTTTT.TTTTTTT.TTTTT.T.T.TTT.TTT.T.TTT
T.T...T.....T.....T.....T.T...T.T.T.....T...T.....T.T...T.T.T.T.T...T.......T.....T.T.T.....T...T.T
T.TTT.TTTTT.TTTTTTT......TT.TTTTT.TTT.TTT.TTTTT.TTTTTTTTT.TTT.T.TTTTTTT.TTT.TTT.TTTTTTT.T.TTT.T.T.T
T.....T...T...........T.T.T.T.....T.T.....T...T...T...T.........T.T.....T.T.T...T.T.T.T.T.T...T...T
TTT.T.T.T.TTT.T.T.T.T.T.T.T.TTT.T.T.TTT.T.T.TTT.TTTTT.TTTTT.T.TTT.TTT.T.T.T.T.T.T.T.T.T.TTT.TTT.T.T
T...T.T.T.T...T.T.T.T.T.........T...T...T...T.T...T.T.....T.T.T.T...T.T.T.....T...T.....T...T...T.T
TTT.T.T.TTTTT.T.T.TTTTT.TTT.TTTTT.T.TTTTTTT.T.T.T.T.T.TTT.T.TTT.TTT.T.TTT.T.TTTTTTTTT.T.T.TTT.TTT.T
T...T...T.T.T.T.T.T.....T.T...T...T.T.T.....T.T.T.T.T.T.....T.T.T.T.....T.T...........T.T.T.....T.T
TTTTT.TTT.T.T.TTTTT.TTT.T.TTT.TTTTTTT.T.TTT.T.TTT.T.TTT.TTTTT.T.T.TTTTT.T.TTTTTTTTTTT.T.TTTTTTT.TTT
T...........T.T.T...T...T.....T.T.........T...T...T.T.......T.T...T...T.T...T...T.....T.T.....T.T.T
T.TTTTT.TTT.T.T.TTT.TTT.T.TTTTT.T............TTTT.T.TTT.TTTTT.T.TTTTT.TTTTTTT.T.TTTTT.TTT.TTTTTTT.T
T...T.T.T.T.T...T.T.T...T.....T...T.......T...T...........T.............T.T...T.T.....T.T.....T...T
T.T.T.T.T.T.T.TTT.TTTTTTTTT.T.TTT.TTTTTTT.T.TTT.TTTTT.TTT.TTT.TTTTT.TTTTT.TTTTT.TTTTTTT.T.TTTTT.TTT
T.T...T.T.........T.T...T.T.T.....T...T.T.T.....T.......T...T.....T.........T.T.T.....T.T.........T
T.TTTTTTT.T.T.TTT.T.TTT.T.TTTTTTTTT.T.T.T........TT.T.T.T.T.TTTTTTTTT.TTT.T.T.T.T.T.TTT.TTTTTTT.TTT
T...T.....T.T...T.T.........T.......T...T.......T...T.T.T.T.....T.T...T.T.T.T...T.T.....T...T.T...T
TTT.T.TTT.TTTTTTTTTTT.T.TTTTTTT.TTT.T.TTTTT.T.TTT.TTTTT.T.TTT.TTT.T.TTT.TTTTT.T.T.T.T.TTTTT.T.T.TTT
T...T...T.T.....T.T.T.T.....T...T...T.T.T...T.T...T.....T...T.................T.T.T.T...T.......T.T
TTTTT.T.T.TTT.TTT.T.TTT.T.......TTT.T.T.T.TTTTT.TTT.T.TTTTTTTTTTTTT.TTTTTTT.TTT.TTTTT.T.TTTTT.TTT.T
T.....T.T.T.......T.....T.....T.....T.....T...T.T.T.T.....T...T.T...T.T.T...T.T.......T.........T.T
TTTTTTTTT.TTT.T.T.TTTTT.T.TTT.TTTTTTTTTTT.TTT.TTT.TTTTT.TTTTT.T.T.T.T.T.TTT.T.T.TTTTTTTTTTTTT.T.T.T
T.....T...T...T.T.T.........T.....T.....T.T...T.T...T...T.T...T.T.T.T.T...T.T.......T.......T.T...T
T.TTTTTTT.T.TTTTTTTTTTT.T.T.TTTTT.T.TTT.T.T.T.T.TTT.TTT.T.T.TTT.TTTTT.T.TTT.TTTTTTTTT.TTT.TTT.T.T.T
T...T.T.T.T.....T.......T.T.T.T.T.....T...T.T.T.....T...T...T...T.........T.T.T.T.......T.....T.T.T
T.TTT.T.TTTTTTT.T.TTTTT.TTTTT.T.T.TTTTT.TTT.TTT.TTT.T.TTTTT.TTT.T.TTTTT.TTTTT.T.T.T.TTT.T.TTTTTTT.T
T.....T...T...T.T.T.T.T...T.T.T...T...T.....T.....T.T.T.....T...T.T.......T.T...T.T...T.T.......T.T
T.TTTTTTT.T.T.T.TTT.T.TTT.T.T.TTT.T.TTTTT.TTT.TTT.T.T.TTTTT.T.TTTTTTT.TTT.T.TTT.T.T.TTTTTTTTT.TTTTT
T...T.T.....T...T.........T...T...T...T.T.T.....T.T.T...T.....T.T...T.T.......T.T.T...T.T...T...T.T
T.T.T.TTT.TTT.T.T.T.TTT.TTTTT.T.TTTTT.T.T.TTTTT.TTT.T.TTTTT.T.T.T.TTTTT.TTTTTTT.T.TTTTT.T.TTT.TTT.T
T.T.......T...T.T.T.T.....T...T.T.....T...T.T.....T.....T...T.T...T...T.....T.T...T...T.T...T...T.T
T.TTT.TTT.TTT.T.......T.T.T.TTT.TTT.T.T.T.T.TTT.T.T.T.T.T.TTT.TTT.T.TTT.TTT.T.TTTTT.T.T.T.T.T.T.T.T
T.T...T.....T.T.........T.T...T...T.T...T...T.T.T.T.T.T...T...T...........T.......T.T.....T...T...T
T.T.T.T.T.T.TTTTTTT.T.TTT.T.TTT.TTT.T.T.T.T.T.TT............T.T.TTT.T.TTTTT.T.T.TTTTTTTTT.TTTTTTTTT
T.T.T.T.T.T.......T.T.T.....T.T.T.T.T.T.T.T.T.................T.T...T...T.T.T.T...T...T.......T...T
TTTTTTT.TTTTT.TTTTT.TTTTTTT.T.TTT.T.TTTTTTT.TTT.TTTTTTTTT.TTTTTTT.TTTTTTT.TTTTTTT.TTT.TTTTT.T.TTT.T
T.......T.T...T...T.T.........T.......T.......T...T.T.......T...T...T...T.T...........T.....T.T...T
TTT.T.TTT.TTTTT.T.T.TTT.TTT.TTTTTTTTT.TTT.TTT.TTTTT.TTT.TTT.TTT.TTTTTTT.T.TTTTT.TTTTT.TTTTTTTTT.TTT
T...T.........T.T...T...T.....T.T.T...T.T...T.T.....T.....T...T.T.T.T.T.......T.T.T.T...T.......T.T
T.TTT.TTT.TTTTTTT.T.TTTTT.TTTTT.T.TTTTT.TTT.TTTTT.TTTTT.T.TTT.T.T.T.T.T.TTTTTTT.T.T.T.TTT.TTT.TTT.T
T.T.T...T.....T...T.T...T.....T.....T.T.......T.......T.T...T.T.T...T.......T.T.T.T.T.....T.......T
TTT.T.TTTTT.TTTTT.TTT.TTT....TT.TTTTT.TTT.T.TTT.T.T.TTT.T.T.TTT.T.TTTTTTTTT.T.T.T.T.T.TTT.T.T.TTTTT
T.......T...T.........T.....T...T.....T...T.T.T.T.T.T.T.T.T.T.......T.....T.T.....T...T.T.T.T...T.T
TTTTT.T.TTTTTTT.T.TTTTT.T.TTT.T.T.T.T.T.TTT.T.T.TTT.T.T.TTT.TTTTT.TTT.TTT.......T.TTT.T.TTT.TTTTT.T
T...T.T.......T.T...T...T...T.T...T.T.T...T...T...T...T...T.....T.....T.T.......T.T.T.....T.T.T.T.T
T.TTTTTTT.T.T.TTT.TTT.TTTTTTTTTTT.TTT.T.T.TTT.T.T.TTTTT.TTTTTTTTT.TTT.T.T.......TTT.TTTTTTT.T.T.T.T
T.T.T.T.T.T.T.T...T.....T...T.T.....T.T.T.T...T.T.....T.............T.......T.T.T.....T.....T...T.T
T.T.T.T.T.TTT.T.T.TTTTT.TTT.T.TTT.TTTTTTT.TTT.T.TTTTTTT.TTTTT.TTT.T.TTT.T.T.T.TTTTT.T.TTT.TTT.T.T.T
T.T...T.T.T...T.T.T.T.....T...T.......T.T...T...T...T.....T...T...T.T...T.T.T...T...T.........T...T
T.T.TTT.T.TTT.TTT.T.T.TTT.TTT.T.TTT.TTT.T.TTT.TTTTT.TTT.TTT.TTTTTTT.TTT.TTT.TTTTTTTTTTT.TTTTT.T.T.T
T.......T.T.............T.T.....T...T.....T.........T.T...T.T.......T.T.T.T.T.............T...T.T.T
TTT.T.T.T.TTTTT.T.TTT.TTT.TTTTTTT.T.TTTTT.T.TTTTT.T.T.T.T.TTTTT.TTTTT.T.T.TTT.T......TT.T.TTTTTTTTT
T...T.T...T.....T.T...T...........T...T...T...T...T.....T...T...T...T.....T...T.....T.T.T.........T
TTT.TTT.T.TTT.TTTTTTT.T.TTTTTTT.TTTTTTTTTTTTT.T.TTTTT.T.T.TTT.T.T.TTT.TTTTT.TTTTT.TTT.TTT.TTTTTTT.T
T...T...T...T...T.....T.T...T.............T...T.....T.T.T.T...T.....T.T.............T...T.T.......T
TTTTTTTTT.T.TTT.TTT.T.T.T.TTT.............T.TTT.TTTTT.TTTTTTTTT.TTT.T.T.T.T.TTT.T.T.T.T.T.TTT.T.T.T
T.....T...T.T.T...T.T.T.T...T.............T.T...T.T.T.T...T.T.T.T...T.T.T.T...T.T.T...T.T.T...T.T.T
T.TTTTTTT.TTT.TTTTTTT.T.T.T.T.............TTT.T.T.T.T.T.TTT.T.T.TTTTT.TTTTT.TTTTTTT.TTT.TTT.TTT.T.T
T.T.........T.......T.T...T.T...T.T...T...T.T.T...T.....T.....T...T.......T...T.T...T.T.T.T...T.T.T
T.TTTTT.TTTTT.TTTTT.TTTTTTT.T.T.T.TTTTTTT.T.T.T.TTTTTTTTT.TTTTT.TTT.T.T.T.T.TTT.TTT.T.T.T.T.T.TTT.T
T.............T.....T.......T.T.......T.....T.T.T.................T.T.T.T.T.......T...T...T.T...T.
TTTTTTTTTTTTTTTTTTTTTTTTTTTTTTTTTTTTTTTTTTTTTTTTTTTTTTTTTTTTTTTTTTTTTTTTTTTTTTTTTTTTTTTTTTTTTTTTT.